Leander	Aase	leandeaa@stud.ntnu.no
Mohamed Said Ahmed	Abdi	msabdi@stud.ntnu.no
Martin Kleven	Akersveen	martikak@stud.ntnu.no
Dovydas	Augustis	dovydasa@stud.ntnu.no
Messa	Azeroglu	messaa@stud.ntnu.no
Agne	Basiul	agneb@stud.ntnu.no
Amund Aas	Bekkevold	amundab@stud.ntnu.no
Jonas Bolsøy	Bjerkeengen	jonasbbj@stud.ntnu.no
Falke	Brautaset	falkebr@stud.ntnu.no
Nicolai	Buseth	nicolbus@stud.ntnu.no
Ralph Matthew Montellano	Cayetano	rmcayeta@stud.ntnu.no
Mohamud Saleban	Elmi	mohamude@stud.ntnu.no
Emil	Endoo	emilend@stud.ntnu.no
Ju Ann Tveit	Eriksen	jaeriks@stud.ntnu.no
Johan Markus	Faanes	johanmfa@stud.ntnu.no
Petter Severinsen	Finn	pettesfi@stud.ntnu.no
Jesper Reitan	Fridén	jesperrf@stud.ntnu.no
Benjamin Godtfred	Hagvin	benjamgh@stud.ntnu.no
Jørgen	Halsa	jorhal@stud.ntnu.no
Thea Madelene	Hansen	theamha@stud.ntnu.no
Tuva Konstanse	Hansen	tuvakh@stud.ntnu.no
Robin Aleksander	Heimdal	robinahe@stud.ntnu.no
Audun Peter	Hoffmann	audunph@stud.ntnu.no
Odd Kristian	Holen	oddkh@stud.ntnu.no
Iselin Chantelle	Holt	iselinch@stud.ntnu.no
Emilie Dyrvik	Homlong	emilidho@stud.ntnu.no
Ben Thomas	Hughes-Tretnes	benhu@stud.ntnu.no
Øystein	Huse	oystein.huse@ntnu.no
Rebecca	Jevne	rebecj@stud.ntnu.no
Marte Cecilie	Kaland	marteck@stud.ntnu.no
Marie Antoinette	Klausen	marieakl@stud.ntnu.no
Tobias	Kristiansen	tobikr@stud.ntnu.no
Tina Vladimirovna	Kucina	tinavk@stud.ntnu.no
Sander Levi	Kval	sanderlk@stud.ntnu.no
Knut Magnus	Kvile	knutmkv@stud.ntnu.no
Emil Voldengen	Larsen	emilvl@stud.ntnu.no
Ine Berge	Lund	inebl@stud.ntnu.no
Adrian David Fonseca	Malvik	admalvik@stud.ntnu.no
Håkon	Mannsåker	haakman@stud.ntnu.no
Anine	Martinsen	aninem@stud.ntnu.no
Sebastian Sæther	Maurbakken	sebamau@stud.ntnu.no
Arbresha	Mehmeti	arbreshm@stud.ntnu.no
Adnan	Muric	adnanmu@stud.ntnu.no
Nhatphong	Nguyen	nhatphon@stud.ntnu.no
Malin Leikanger	Nordraak	malinlno@stud.ntnu.no
Joakim Vatnehol	Pedersen	joakimvp@stud.ntnu.no
Sehrish	Razi	sehrishr@stud.ntnu.no
Synne Fuglesang	Sæther	synnefsa@stud.ntnu.no
Chanya	Sanboonsiri	chanyas@stud.ntnu.no
Vilde Linnea Olsen	Sivertsen	vlsivert@stud.ntnu.no
Mona Moe	Sognar	monams@stud.ntnu.no
Shu Shu	Somesi	shuss@stud.ntnu.no
Live Seung Hee Vestbø	Thu	lsthu@stud.ntnu.no
Mathias Fornes	Torsteinshaugen	mathiaft@stud.ntnu.no
Pau Sawm	Tung	paut@stud.ntnu.no
Martin Vefring	Ullaland	martivu@stud.ntnu.no
Ask Oliver	Vighals	askov@stud.ntnu.no
Rebeka Ingrid	Walczuk	rebekaiw@stud.ntnu.no
Oleksandra	Zakharchuk	oleksaz@stud.ntnu.no
Zhenya Ivanova	Zhelyazkova	zhenyaiz@stud.ntnu.no